0 0 0 0 0 0 0 0 0 0 0 0 0 0 0 0
0 0 0 0 0 0 0 0 0 0 0 0 0 0 0 0
0 0 0 0 0 3 0 0 6 6 0 0 0 3 0 0
0 0 0 0 0 0 0 0 6 6 0 0 0 0 0 0
0 0 0 0 0 0 0 0 0 0 0 0 0 0 0 0
0 0 0 0 0 0 0 1 1 1 1 1 1 0 0 0
0 0 0 0 0 0 0 1 2 2 2 2 1 0 0 0
0 0 0 0 0 4 0 1 2 2 2 2 1 0 0 0
0 0 0 0 0 0 0 1 2 2 2 2 1 0 0 0
0 0 0 0 0 0 0 1 1 1 1 1 1 0 0 0
0 0 0 0 0 0 4 0 0 0 0 0 0 0 4 0
0 0 0 0 0 0 0 0 0 0 0 0 0 0 0 0