38 38 38 38 38 38 38 38 38 38 38 38 38 38 38 38 38 38 38 38 38 38 38 25 1 1 21 38 38 38 38 38 38 38 38 38 38 38 38 38 38 38 38 38 38 38 38 38 38 38
38 38 38 38 38 38 38 38 38 38 38 38 38 38 38 38 38 38 38 38 38 38 38 25 1 1 21 38 38 38 38 38 38 38 38 38 38 38 38 38 38 38 38 38 38 38 38 38 38 38
38 38 38 38 38 38 38 38 38 38 38 38 38 38 38 38 38 38 38 38 38 38 38 25 1 1 21 38 38 38 38 38 38 38 38 38 38 38 38 38 38 38 38 38 38 38 38 38 38 38
38 38 38 38 38 38 38 38 38 38 38 38 38 38 38 38 38 38 38 38 38 38 38 25 1 1 21 38 38 38 38 38 38 38 38 38 38 38 38 38 38 38 38 38 38 38 38 38 38 38
38 38 38 38 38 38 38 38 38 38 38 38 38 38 38 38 38 38 38 38 38 38 38 25 1 1 21 38 38 38 38 38 38 38 38 38 38 38 38 38 38 38 38 38 38 38 38 38 38 38
38 38 38 38 38 38 38 38 38 38 38 38 38 38 38 38 38 38 38 38 38 38 38 25 1 1 21 38 38 38 38 38 38 38 38 38 38 38 38 38 38 38 38 38 38 38 38 38 38 38
38 38 38 38 38 38 38 38 38 38 38 38 38 38 38 38 38 38 38 38 38 38 38 25 1 1 21 38 38 38 38 38 38 38 38 38 38 38 38 38 38 38 38 38 38 38 38 38 38 38
38 38 38 38 38 38 38 38 38 38 38 38 38 38 38 38 38 38 38 38 38 38 38 25 1 1 21 38 38 38 38 38 38 38 38 38 38 38 38 38 38 38 38 38 38 38 38 38 38 38
38 38 38 38 38 38 38 38 38 38 38 38 38 38 38 38 38 38 38 38 38 38 38 25 1 1 21 38 38 38 38 38 38 38 38 38 38 38 38 38 38 38 38 38 38 38 38 38 38 38
38 38 38 38 38 38 38 38 38 38 38 38 38 38 38 38 38 38 38 38 38 38 38 25 1 1 21 38 38 38 38 38 38 38 38 38 38 38 38 38 38 38 38 38 38 38 38 38 38 38
38 38 38 38 38 38 38 38 38 38 38 38 38 38 38 38 38 38 38 38 38 38 38 25 28 28 21 38 38 38 38 38 38 38 38 38 38 38 38 38 38 38 38 38 38 38 38 38 38 38
38 38 38 38 38 38 38 38 38 38 38 38 38 38 38 38 38 38 38 38 38 38 38 25 1 1 21 38 38 38 38 38 38 38 38 38 38 38 38 38 38 38 38 38 38 38 38 38 38 38
38 38 38 38 38 38 38 38 38 38 38 38 38 38 38 38 38 38 38 38 38 38 38 25 1 1 21 38 38 38 38 38 38 38 38 38 38 38 38 38 38 38 38 38 38 38 38 38 38 38
38 38 38 38 38 38 38 38 38 38 38 38 38 38 38 38 38 38 38 38 38 38 38 25 1 1 21 38 38 38 38 38 38 38 38 38 38 38 38 38 38 38 38 38 38 38 38 38 38 38
38 38 38 38 38 38 38 38 38 38 38 38 38 38 38 38 38 38 38 38 38 38 38 25 1 1 21 38 38 32 31 31 31 31 31 31 31 31 31 31 31 31 31 31 31 31 30 0 0 38
38 38 38 38 38 38 38 38 38 38 38 38 38 38 38 38 38 38 38 38 38 38 38 25 1 1 21 38 38 33 2 2 2 2 2 2 2 2 2 2 2 2 2 2 2 2 34 0 0 38
38 0 0 32 31 31 31 31 31 31 31 31 31 31 31 31 31 31 31 31 30 38 38 25 28 28 21 38 38 33 2 2 2 2 2 2 2 2 2 2 2 2 2 2 2 2 34 0 0 38
38 0 0 33 2 2 2 2 2 2 2 2 2 2 2 2 2 2 2 2 34 38 38 25 1 1 21 38 38 33 2 2 2 2 2 2 2 2 2 2 2 2 2 2 2 2 34 0 0 38
38 0 0 33 2 2 2 2 2 2 2 2 2 2 2 2 7 7 9 2 34 38 38 25 1 1 21 38 38 33 2 9 9 2 5 2 2 2 2 2 2 2 2 2 2 2 34 0 0 38
38 0 0 33 2 2 2 2 2 2 2 2 2 2 2 11 8 2 5 2 34 38 38 25 1 1 21 38 38 33 7 7 2 8 2 11 2 2 2 2 2 2 2 2 2 2 34 0 0 38
38 0 0 36 37 37 37 37 37 37 37 37 37 37 37 37 37 37 37 37 35 38 38 25 1 1 21 38 38 36 37 37 37 37 37 37 37 37 37 37 37 37 37 37 37 37 35 0 0 38
38 0 0 0 0 0 0 0 0 6 6 0 0 0 0 38 38 38 38 6 6 4 38 25 1 1 21 38 38 38 4 10 0 0 0 0 0 0 0 0 0 0 0 0 0 0 0 0 0 38
38 0 0 0 0 0 0 0 0 6 6 0 0 0 0 38 38 38 38 6 6 38 38 25 1 1 21 3 38 38 10 10 0 0 0 0 0 0 0 0 0 0 0 0 0 0 0 0 0 38
38 19 19 19 19 19 19 19 19 19 19 19 19 19 19 19 19 19 19 19 19 19 19 24 1 1 22 19 19 19 19 19 19 19 19 19 19 19 19 19 19 19 19 19 19 19 19 19 19 38
38 1 1 1 1 1 1 1 1 1 1 1 1 1 1 1 28 1 1 1 29 28 1 1 1 1 1 1 28 29 1 1 1 1 1 1 1 1 1 1 1 1 1 1 1 1 1 1 1 38
38 1 1 1 1 1 1 1 1 1 1 1 1 1 1 1 28 1 1 1 1 29 1 1 1 1 1 1 1 1 29 29 1 1 1 1 1 1 1 1 1 1 1 1 1 1 1 1 1 38
38 27 27 27 27 27 27 27 27 27 27 27 27 27 27 27 27 27 27 27 27 27 27 26 1 1 20 27 27 27 27 27 27 27 27 27 27 27 27 27 27 27 27 27 27 27 27 27 27 38
38 0 0 0 0 0 0 0 0 0 0 0 0 38 38 38 38 38 38 38 38 0 38 25 1 29 21 38 38 6 6 0 0 0 0 0 0 0 0 0 0 0 0 0 0 0 0 0 0 38
38 0 0 0 0 0 0 0 0 0 0 0 0 38 38 38 38 38 38 0 0 0 38 25 29 29 21 38 38 6 6 0 0 0 0 0 0 0 0 0 0 0 0 0 0 0 0 0 0 38
38 0 0 32 31 31 31 31 31 31 31 31 31 31 31 31 31 31 31 31 30 38 38 25 1 1 21 38 38 38 0 0 0 38 38 38 38 38 38 38 38 38 38 38 38 38 38 38 38 38
38 0 0 33 2 2 2 2 2 2 2 2 2 2 2 8 8 2 7 7 34 38 38 25 1 1 21 38 38 38 0 0 0 38 38 38 38 38 38 38 38 38 38 38 38 38 38 38 38 38
38 0 0 33 2 2 2 2 2 2 2 2 2 2 2 2 2 5 11 11 34 38 38 25 1 1 21 38 38 38 0 0 0 38 38 38 38 38 38 38 38 38 38 38 38 38 38 38 38 38
38 0 0 33 2 2 2 2 2 2 2 2 2 2 2 2 2 9 2 2 34 38 38 25 28 28 21 38 38 38 0 0 0 38 38 38 38 38 38 38 38 38 38 38 38 38 38 38 38 38
38 0 0 33 2 2 2 2 2 2 2 2 2 2 2 2 2 2 2 2 34 38 38 25 1 1 21 38 38 38 0 0 0 38 38 38 38 38 38 38 38 38 38 38 38 38 38 38 38 38
38 0 0 36 37 37 37 37 37 37 37 37 37 37 37 37 37 37 37 37 35 38 38 25 1 1 21 38 38 38 0 0 0 0 0 0 0 0 0 0 0 0 0 0 0 0 0 38 38 38
38 38 38 38 38 38 38 38 38 38 38 38 38 38 38 38 38 38 38 38 38 38 38 25 1 1 21 38 38 38 0 0 0 0 0 0 0 0 0 0 0 0 0 0 0 0 0 38 38 38
38 38 38 38 38 38 38 38 38 38 38 38 38 38 38 38 38 38 38 38 38 38 38 25 1 1 21 38 38 38 0 0 0 0 0 0 0 0 0 0 0 0 0 0 0 0 0 38 38 38
38 38 38 38 38 38 38 38 38 38 38 38 38 38 38 38 38 38 38 38 38 38 38 25 1 1 21 38 38 38 38 38 38 38 38 0 0 0 0 0 0 0 0 0 0 0 0 38 38 38
38 38 38 38 38 38 38 38 38 38 38 38 38 38 38 38 38 38 38 38 38 38 38 25 1 1 21 38 38 38 38 38 38 38 38 0 0 6 6 6 0 0 0 0 0 0 0 38 38 38
38 38 38 38 38 38 38 38 38 38 38 38 38 38 38 38 38 38 38 38 38 38 38 25 1 1 21 38 38 38 38 38 38 38 38 0 0 6 6 6 0 10 10 0 0 0 0 38 38 38
38 38 38 38 38 38 38 38 38 38 38 38 38 38 38 38 38 38 38 38 38 38 38 25 1 1 21 38 38 38 38 38 38 38 38 0 0 6 6 6 0 10 10 10 0 0 0 38 38 38
38 38 38 38 38 38 38 38 38 38 38 38 38 38 38 38 38 38 38 38 38 38 38 25 1 1 21 38 38 38 38 38 38 38 38 0 0 0 0 0 0 10 10 10 10 0 0 38 38 38
38 38 38 38 38 38 38 38 38 38 38 38 38 38 38 38 38 38 38 38 38 38 38 25 1 1 21 38 38 38 38 38 38 38 38 0 0 0 0 0 0 10 10 10 10 10 0 38 38 38
38 0 0 0 0 0 0 0 0 0 0 0 0 0 0 0 0 0 0 0 0 0 0 25 1 1 21 38 38 38 38 38 38 38 38 0 0 0 0 0 0 0 0 0 0 0 0 38 38 38
38 0 0 0 0 0 0 0 0 0 0 0 0 0 0 0 0 0 0 0 0 0 0 25 1 1 21 38 38 38 38 38 38 38 38 0 0 0 0 0 0 0 0 0 0 0 0 38 38 38
38 0 0 0 0 0 0 0 0 0 0 0 0 0 0 0 0 0 0 0 0 0 0 25 1 1 21 38 38 38 38 38 38 38 38 0 0 0 0 0 0 0 0 0 0 0 0 38 38 38
38 0 0 0 0 0 0 0 0 0 0 0 0 0 0 0 0 0 0 0 0 0 0 25 1 1 21 38 38 38 38 38 38 38 38 0 0 0 0 0 0 0 0 0 0 0 0 38 38 38
38 0 0 0 0 0 0 0 0 0 0 0 0 0 0 0 0 0 0 0 0 0 0 25 1 1 21 38 38 38 38 38 38 38 38 38 38 38 38 38 38 38 38 38 38 38 38 38 38 38
38 0 0 0 0 0 0 0 0 0 0 0 0 0 0 0 0 0 0 0 0 0 0 25 1 1 21 38 38 38 38 38 38 38 38 38 38 38 38 38 38 38 38 38 38 38 38 38 38 38
38 38 38 38 38 38 38 38 38 38 38 38 38 38 38 38 38 38 38 38 38 38 38 25 1 1 21 38 38 38 38 38 38 38 38 38 38 38 38 38 38 38 38 38 38 38 38 38 38 38